+---+---+---+---+---+---+---+---+---+---+---+---+---+---+---+---+
|                                                               |
+   +   +   +   +   +   +   +   +   +   +   +   +   +   +   +   +
|                                                               |
+   +   +   +   +   +   +   +   +   +   +   +   +   +   +   +   +
|                                                               |
+   +   +   +   +   +   +   +   +   +   +   +   +   +   +   +   +
|                                                               |
+   +   +   +   +   +   +   +   +   +   +   +   +   +   +   +   +
|                                                               |
+   +   +   +   +   +   +   +   +   +   +   +   +   +   +   +   +
|                                                               |
+   +   +   +   +   +   +   +   +   +   +   +   +   +   +   +   +
|                                                               |
+   +   +   +   +   +   +   +   +   +   +   +   +   +   +   +   +
|                                                               |
+   +   +   +   +   +   +   +   +   +   +   +   +   +   +   +   +
|                                                               |
+   +   +   +   +   +   +   +   +   +   +   +   +   +   +   +   +
|                                                               |
+   +   +   +   +   +   +   +   +   +   +   +   +   +   +   +   +
|                                                               |
+   +   +   +   +   +   +   +   +   +   +   +   +   +   +   +   +
|                                                               |
+   +   +   +   +   +   +   +   +   +   +   +   +   +   +   +   +
|                                                               |
+   +   +   +   +   +   +   +   +   +   +   +   +   +   +   +   +
|                                                               |
+   +   +   +   +   +   +   +   +   +   +   +   +   +   +   +   +
|                                                               |
+   +   +   +   +   +   +   +   +   +   +   +   +   +   +   +   +
|                                                               |
+---+---+---+---+---+---+---+---+---+---+---+---+---+---+---+---+
